20
62 65 19 65 6 45 55 73 19 18 78 51 46 62 67 30 26 3 23 
  67 18 42 28 38 56 71 58 39 21 38 69 66 37 3 22 5 32 
    13 47 62 16 3 28 75 3 4 11 39 37 49 60 57 34 40 
      51 53 74 22 5 9 41 41 22 7 32 47 29 56 49 61 
        54 41 43 8 66 47 76 66 73 32 27 37 46 72 26 
          78 68 73 47 29 31 18 53 28 78 49 53 68 16 
            41 52 80 17 77 70 8 66 52 44 66 42 3 
              56 48 46 12 36 67 12 65 70 8 58 70 
                64 16 61 77 14 6 21 7 60 59 4 
                  29 74 36 58 78 27 52 31 51 73 
                    4 59 80 25 53 34 76 68 3 
                      5 67 23 58 5 19 30 80 
                        12 5 72 10 41 37 24 
                          38 55 41 73 47 61 
                            56 24 13 35 10 
                              38 21 20 21 
                                2 24 60 
                                  37 39 
                                    34 
