15
81 85 88 82 82 89 88 83 84 83 87 84 86 84 
  87 82 81 83 90 87 85 90 89 84 82 87 85 
    81 86 84 85 89 81 85 85 86 86 90 83 
      87 83 84 89 88 86 85 82 84 85 85 
        87 84 84 90 80 85 80 80 88 80 
          83 89 90 88 82 81 82 85 82 
            88 84 83 89 82 82 80 81 
              86 89 87 82 85 88 87 
                88 81 90 83 82 83 
                  89 86 83 86 85 
                    87 88 86 80 
                      90 90 90 
                        80 84 
                          89 
