12
5 9 3 6 2 8 2 6 7 6 8 
  7 4 7 6 5 3 5 3 9 8 
    9 8 4 6 9 9 5 2 7 
      2 7 9 5 9 3 2 7 
        4 2 6 3 4 9 8 
          3 7 9 3 8 4 
            8 7 8 8 5 
              6 7 9 6 
                3 6 5 
                  6 6 
                    4 
