15
9 7 6 4 8 3 5 2 2 4 6 9 7 2 
  2 3 7 4 9 3 4 8 6 9 6 3 4 
    8 5 8 7 8 4 7 5 6 8 2 5 
      7 4 3 7 6 7 6 4 5 6 2 
        8 6 5 9 3 6 7 6 6 8 
          3 5 3 3 4 5 3 5 9 
            7 5 9 9 7 8 9 9 
              4 6 6 2 9 3 5 
                7 4 8 7 5 4 
                  8 4 8 4 3 
                    7 8 7 9 
                      9 3 6 
                        3 5 
                          2 
